category	abbrevs
FATTY ACIDS	FA
METABOLIC INTERMEDIATES	META
HEAVY METALS	HEAV
ORGANIC ACIDS	OACID
HYDROGEN	H2
FLAVANOIDS	FLAV
DIAMINE	DIA
SOLVENTS	SOLV
DIOLS	DIOLS
PROTEIN	PROT
TERPENOIDS	TERP
PHENOLICS	PHEN
DNA	DNA
SUGAR ALCOHOL	SUGA
ETHYLENE GLYCOL	ETGL
ALCOHOLS	ALC
CHALCONE	CHAL
AMINO ACIDS	AA
VITAMINS	VITA
BIOPOLYMER	POLY
BIOMASS	BIOM
HYDROCARBON	HYC
