mutation	abbrevs
MUTATED	UNK
Other	OTH
DEL	DEL
PLASMID	PLA
CON	CON
INDEL	INDEL
TERMINATED	TER
PROTEIN_FUSION	FUSE
large_inversion	LINV
is_insertion	TN
rep	REP
frameshift	FRAME
REGULATED	REG
INTEGRATED	INT
SCAFFOLD_BINDER	SCFB
AA_SNPS	AA*
NUC_SNPS	SNP
CODONOPTIMIZED	C-OPT
TRUNCATED	TRC
OE	OE
ANTISENSE	ASEN
RBS_TUNED	RBS-T
large_amplification	LAMP
large_deletion	LDEL
AMPLIFIED	AMP
duplication	DUPE
intergenic	BTW
COMPARTMENTALIZATION	COMP
