Phenotype	Dummy Column	DummyColumn2	Standardized Name
1_10-PHENANTHROLINE	None	None	1_10-PHENANTHROLINE
1-2-4-BUTANETRIOL	None	None	1-2-4-BUTANETRIOL
1-2-PROPANEDIOL CONSUMPTION	None	None	1-2-PROPANEDIOL
18-CROWN-6 ETHER	None	None	18-CROWN-6 ETHER
1-HEXENE	None	None	1-HEXENE
1-NAPHTHOL	None	None	1-NAPHTHOL
2_2'-DIPYRIDYL	None	None	2_2'-DIPYRIDYL
2_4-DIAMINO-6_7-DIISOPROPYL-PTERIDINE	None	None	2_4-DIAMINO-6_7-DIISOPROPYL-PTERIDINE
2-BUTANOL	None	None	2-BUTANOL
3_4-DIMETHOXYBENZYL ALCOHOL	None	None	3_4-DIMETHOXYBENZYL ALCOHOL
3_5-DINITROBENZENE	None	None	3_5-DINITROBENZENE
3-HP	None	None	3-HP
4-AZA-DL-LEUCINE	None	None	4-AZA-DL-LEUCINE
5-CHLORO-7-IODO-8-HYDROXYQUINOLINE	None	None	5-CHLORO-7-IODO-8-HYDROXYQUINOLINE
5-NITRO-2-FURALDEHYDE SEMICARBAZONE	None	None	5-NITRO-2-FURALDEHYDE SEMICARBAZONE
6-HYDROXY-2-NAPHTHOIC ACID	None	None	6-HYDROXY-2-NAPHTHOIC ACID
6-HYDROXYLAMINOPURINE	None	None	6-HYDROXYLAMINOPURINE
6-Mercaptopurine	None	None	6-Mercaptopurine
5_7-DICHLORO-8-HYDROXYQUINALDINE	None	None	7-DICHLORO-8-HYDROXYQUINALDINE
8-HYDROXYQUINOLINE	None	None	8-HYDROXYQUINOLINE
9-Aminoacridine	None	None	9-Aminoacridine
A22	None	None	A22
ACETATE	None	None	ACETATE
ACETIC ACID	None	None	ACETATE
ACID	None	None	ACID
ACID STRESS	None	None	ACID
PH4 	None	None	ACID
PH4.5 	None	None	ACID
PH5 	None	None	ACID
PH6 	None	None	ACID
ACRIFLAVINE	None	None	ACRIFLAVINE
ACTINOMYCIND	None	None	ACTINOMYCIN D
ADRIAMYCIN	None	None	ADRIAMYCIN
ALANINE UTILIZATION	None	None	ALANINE UTILIZATION
ALA-ASN	None	None	Alanine-Asparagine
ALA-LEU	None	None	Alanine-Leucine
ALA-SER	None	None	Alanine-Serine
ATA-SER	None	None	ALANINE-SERINE
ALHPA-KETOGLUTARATE	None	None	ALHPA-KETOGLUTARATE
ALKALINE	None	None	ALKALINE
PH10 	None	None	ALKALINE
PH8 	None	None	ALKALINE
PH9 	None	None	ALKALINE
PH9.5 	None	None	ALKALINE
ALKALINE AMINO ACID UTILIZATION	None	None	ALKALINE AMINO ACID UTILIZATION
ALPHA-HYDROXYBUTYRATE	None	None	ALPHA-HYDROXYBUTYRATE
ALPHA-KETOBUTYRATE	None	None	ALPHA-KETOBUTYRATE
ALPHA-METHYL-D-GALACTOSIDE	None	None	ALPHA-METHYL-D-GALACTOSIDE
ALPHA-PINENE	None	None	ALPHA-PINENE
AMIKACIN	None	None	AMIKACIN
Amitriptyline	None	None	Amitriptyline
NH4CL 	None	None	Ammonia Chloride
AMOXICILLIN	None	None	AMOXICILLIN
AMP	None	None	Ampicillin
AMPICILLIN	None	None	AMPICILLIN
ANAEROBIC 	None	None	Anaerobic
ANTIBIOTIC	None	None	ANTIBIOTICS
ANTIBIOTICS	None	None	ANTIBIOTICS
ANTIMICROBIAL PEPTIDE	None	None	ANTIMICROBIAL PEPTIDE
ANTIMONITE	None	None	ANTIMONITE
ANTIMONY	None	None	ANTIMONY
ANTIMONY (III) CHLORIDE	None	None	ANTIMONY
Apramycin	None	None	Apramycin
ARG-ARG	None	None	Arginine-Arginine
ARG-LYS	None	None	Arginine-Lysine
ARG-PHE	None	None	Arginine-Phenylalanine
ARG-TYR	None	None	Arginine-Tyrosine
ARSENIC	None	None	ARSENIC
ARSENITE	None	None	ARSENITE
PMX	none	none	Arylamide Foldamers
ASPARAGINE	None	None	ASPARAGINE UTILIZATION
ASPARAGINE UTILIZATION	None	None	ASPARAGINE UTILIZATION
D-ASPARAGINE	None	None	ASPARAGINE UTILIZATION
ASPARTATE ACID HYDROXYMATE	None	None	ASPARTATE ACID HYDROXYMATE
ASPARTIC ACID BETA-HYDROXAMATE	None	None	ASPARTATE ACID HYDROXYMATE
ASPARTATE	None	None	Aspartate Utilization
ASP-LEU	None	None	Aspartate-Leucine
ASP-PHE	None	None	Aspartate-Phenylalanine
AZETREONAM	None	None	AZETREONAM
AZTREONAM	None	None	AZETREONAM
AZIDOTHYMIDINE	None	None	AZIDOTHYMIDINE
AZT	None	None	AZIDOTHYMIDINE
AZITHROMYCIN	None	None	AZITHROMYCIN
BACIMETHRIN	None	None	BACIMETHRIN
BACITRACIN	None	None	BACITRACIN
BENZALKONIUM	None	None	BENZALKONIUM CHLORIDE
BENZALKONIUM CHLORIDE	None	None	BENZALKONIUM CHLORIDE
BENZETHONIUM CHLORIDE	None	None	BENZETHONIUM CHLORIDE
BENZOATE	None	None	BENZOATE
BERBERINE	None	None	BERBERINE
BETA-AMINO-N-VALERATE	None	None	BETA-AMINO-N-VALERATE
BETA-CHLORO-L-ALANINE	None	None	BETA-CHLORO-L-ALANINE
BETA-D-ALLOSE	None	None	BETA-D-ALLOSE
BETA-HYDROXYPYRUVATE	None	None	BETA-HYDROXYPYRUVATE
BETA-LACTAM	None	None	BETA-LACTAM antibiotics
BETA-METHYL-D-GLUCURONATE	None	None	BETA-METHYL-D-GLUCURONATE
BICYCLOMYCIN	None	None	BICYCLOMYCIN
BILE	None	None	BILE
BLASTICIDIN S	None	None	BLASTICIDIN
BLEACH	None	None	BLEACH
HOCL	None	None	BLEACH
BLEOMYCIN	None	None	BLEOMYCIN
BROMOACETATE	None	None	BROMOACETATE
BROMOSUCCINATE	None	None	BROMOSUCCINATE
BULGECIN	None	None	BULGECIN
Butanediol	None	None	Butanediol
BUTYL ACETATE	None	None	BUTYL ACETATE
BUTYROLACTONE	None	None	BUTYROLACTONE
CADMIUM	None	None	CADMIUM
CAFFEINE	None	None	CAFFEINE
CALCOFLUOR 	None	None	CALCOFLUOR 
CAMPHOR	None	None	CAMPHOR
CAPREOMYCIN	None	None	CAPREOMYCIN
CARBENICILLIN	None	None	CARBENICILLIN
CO	none	none	carbon monoxide
CARBONYL CYANIDE M-CHLOROPHENYL HYDRAZONE	None	None	CCCP
CCCP	None	None	CCCP
CECROPIN A	none	none	CECROPIN A
CECROPINB	None	None	CECROPIN B
CEFACLOR	None	None	CEFACLOR
CEFAMANDOLE	None	None	CEFAMANDOLE
Cefazolin	None	None	Cefazolin
CEFEPIME	None	None	CEFEPIME
CEFIXIME	None	None	CEFIXIME
Cefoperazone	None	None	Cefoperazone
CEFOXITIN	None	None	CEFOXITIN
CEFSULODIN	None	None	CEFSULODIN
CEFSULODIN	None	None	CEFSULODIN
CEFTAZIDIME	None	None	CEFTAZIDIME
CEFTRIAXONE	None	None	CEFTRIAXONE
CEFUROXIME	None	None	CEFUROXIME
CELL WALL INHIBITORS	None	None	CELL WALL INHIBITORS
CEPHALORIDINE	None	None	CEPHALORIDINE
CEPHALOTHIN	None	None	CEPHALOTHIN
CERULENIN	None	None	CERULENIN
CESIUM CHLORIDE	None	None	CESIUM CHLORIDE
CETRIMIDE	None	None	CETRIMIDE
CETYLDIMETHYLETHYL AMMONIUM BROMIDE	None	None	CETYLDIMETHYLETHYL AMMONIUM BROMIDE
CETYLPYRIDINIUM BROMIDE	None	None	CETYLPYRIDINIUM BROMIDE
CETYLPYRIDINIUM CHLORIDE	None	None	CETYLPYRIDINIUM CHLORIDE
CPC	None	None	CETYLPYRIDINIUM CHLORIDE
CETYLTRIMETHYL AMMONIUM BROMIDE	None	None	CETYLTRIMETHYL AMMONIUM BROMIDE
CHELERYTHRINE	None	None	CHELERYTHRINE
CHIR090	None	None	CHIR-090
CAM	None	None	CHLORAMPHENICOL
CHLORAMPHENICOL	None	None	CHLORAMPHENICOL
CHLORATE	None	None	CHLORATE
CHLOROPROMAZINE	None	None	CHLOROPROMAZINE
Chlorpromazine	None	None	Chlorpromazine
CHOLATE	None	None	CHOLATE
CHROMIUM	None	None	CHROMIUM
CINNAMALDEHYDE	none	none	CINNAMALDEHYDE
CIPROFLAXIN	None	None	CIPROFLOXACIN
CIPROFLOXACIN	None	None	CIPROFLOXACIN
CISPLATIN	None	None	CISPLATIN
CITRATE	None	None	CITRATE
CITRIC ACID	None	None	CITRATE
CLARYTHROMYCIN	None	None	CLARYTHROMYCIN
CLINDAMYCIN	None	None	CLINDAMYCIN
CLO	None	None	clotrimazole
COBALT	None	None	COBALT
COBALT CHLORIDE	None	None	COBALT
COCL2	None	None	COBALT
COLD	None	None	COLD
LOW TEMPERATURE	None	None	COLD
Reduced temperature	None	None	Cold
COLICIN E2	None	None	COLICIN E2
COLISTIN	None	None	COLISTIN
CUPRIC CHLORIDE	None	None	COPPER
COPPER	None	None	COPPER
Crotonate	None	None	CROTONATE
CROTONIC-ACID-NA	None	None	CROTONATE
CRYSTAL VIOLET	None	None	CRYSTAL VIOLET
CUMENE HYDROPEROXIDE	None	None	CUMENE HYDROPEROXIDE
CYCLOHEXANE	None	None	CYCLOHEXANE
CYSTINE	None	None	CYSTINE
D_L-Methionine hydroxamate	None	None	D_L-Methionine hydroxamate
D-ALA-GLY-GLY	None	None	D-ALA-GLY-GLY
D-ALANINE	None	None	D-ALANINE UTILIZATION
D-ALA-GLY	None	None	D-Alanine-Glycine
CYCLOSERINED	None	None	D-CYCLOSERINE
D-CYCLOSERINE	None	None	D-CYCLOSERINE
Decanoic acid	None	None	Decanoic acid
DEOXYCHOLATE	None	None	DEOXYCHOLATE
DEOXYCHOLIC ACID	None	None	DEOXYCHOLIC ACID
DEHYDRATION	None	None	DESSICATION
DESICCATION	None	None	DESSICATION
DESSICATION	None	None	DESSICATION
D-FRUCTOSE	None	None	D-FRUCTOSE
D-FRUCTOSE 6-PHOSPHATE	None	None	D-FRUCTOSE 6-PHOSPHATE
D-GLUCOSE 6-PHOSPHATE	None	None	D-GLUCOSE 6-PHOSPHATE
D-GLUCURONATE	None	None	D-GLUCURONATE
4_5-Dihydroxy-2-Cyclopenten-1-One	none	none	DHCP
DIBUCAINE	None	None	DIBUCAINE
D-L-ALANOSINE	None	None	D-L-ALANOSINE
DL-ALPHA-GLYCEROL PHOSPHATE	None	None	DL-ALPHA-GLYCEROL PHOSPHATE
D-LYSINE	None	None	D-LYSINE UTILIZATION
D-MANNITOL	None	None	D-MANNITOL
D-MELIBIOSE	None	None	D-MELIBIOSE
DMP 840	None	None	DMP 840
Dodecyltrimethyl ammonium bromide	None	None	Dodecyltrimethyl ammonium bromide
DOXORUBICIN	None	None	DOXORUBICIN
DOXYCYCLINE	None	None	DOXYCYCLINE
D-VALINE	None	None	D-VALINE
EDTA	None	None	EDTA
EGCG	None	None	EGCG
EGTA	None	None	EGTA
ENOXACIN	None	None	ENOXACIN
EPINEPHRINE	None	None	EPINEPHRINE
ERM	None	None	ERYTHROMYCIN
ERYTHROMYCIN	None	None	ERYTHROMYCIN
ETHANOL	None	None	ETHANOL
ETHIDIUM BROMIDE	None	None	ETHIDIUM BROMIDE
ETHIDIUMBROMIDE	None	None	ETHIDIUM BROMIDE
ETHYLENE GLYCOL	None	None	ETHYLENE GLYCOL
ETOPOSIDE	None	None	ETOPOSIDE
FCCP	None	None	FCCP
FLOR	None	None	Florfenicol
FLUOROQUINOLONE	None	None	FLUOROQUINOLONE
QUINOLONE	None	None	FLUOROQUINOLONE
TOPOISOMERASE INHIBITORS	None	None	FLUOROQUINOLONE
FOSFOMYCIN	None	None	FOSFOMYCIN
FREEZE THAW CYCLES	None	None	FREEZE THAW CYCLES
FUCOSE	None	None	FUCOSE
Fumarate	None	None	FUMARATE
FUMARIC ACID	None	None	FUMARATE
FURALTADONE	None	none	FURALTADONE
FURFURAL	None	None	FURFURAL
Fusaric acid	None	None	Fusaric acid
FUS	None	None	FUSIDIC ACID
FUSIDIC ACID	None	None	FUSIDIC ACID
FUSIDICACID	None	None	FUSIDIC ACID
GALLIC ACID	None	None	GALLIC ACID
GAMMA RAYS	None	None	GAMMA RAYS
GENETICIN	None	None	GENTAMICIN
GENTAMICIN	None	None	GENTAMICIN
GENTAMYCIN	None	None	GENTAMICIN
GERANIOL	None	None	GERANIOL
GLUCONATE CONSUMPTION	None	None	GLUCONATE CONSUMPTION
GLUCOSAMINE 	None	None	GLUCOSAMINE 
GLUCOSE	None	None	GLUCOSE
GLUCOSE 	None	None	GLUCOSE 
Glucose LIMITATION	None	None	Glucose LIMITATION
GLUCURONAMIDE	None	None	GLUCURONAMIDE
GLUFOSFOMYCIN	None	None	GLUFOSFOMYCIN
GLU-TRP	None	None	Glutamate-Tryptophan
GLUTATHIONE	None	None	GLUTATHIONE
GLYCEROL	None	None	GLYCEROL
GLYCEROL CONSUMPTION	None	None	GLYCEROL
GLYCEROL 	None	None	GLYCEROL 
GLYCINE UTILIZATION	None	None	GLYCINE UTILIZATION
GLY-D-ALA	None	None	Glycine-D-alanine
GLY-GLY-D-LEU	None	None	Glycine-Glycine-D-Leucine
GLY-GLY-LEU	None	None	Glycine-Glycine-Leucine
GLY-PHE-PHE	None	None	Glycine-Phenylalanine-Phenylalanine
GLY-TYR	None	None	Glycine-Tyrosine
GLYCYL-L-ASPARTATE	None	None	GLYCYL-L-ASPARTATE
GLYCYL-L-LEUCINE	None	None	GLYCYL-L-LEUCINE
GLYOXAL	None	None	GLYOXAL
GLYOXYLATE	None	None	GLYOXYLATE
GLYPHOSATE	None	None	GLYPHOSPHATE
GLYPHOSPHATE	None	None	GLYPHOSPHATE
GOLD	none	none	GOLD
GROWTH	None	None	GROWTH
GROWTH DEFECT SUPPRESSOR	None	None	GROWTH
GUANAZOLE	None	None	GUANAZOLE
GUANIDINE HYDROCHLORIDE	None	none	GUANIDINE HYDROCHLORIDE
GUANOSINE	None	None	GUANOSINE
H2O2	None	None	H2O2
HYDROGEN PEROXIDE	None	None	H2O2
HARMANE	None	None	HARMANE
HEAT	None	None	HEAT
HIGH TEMPERATURE	None	None	HEAT
HIGH PRESSURE	None	None	HIGH PRESSURE
HIS-TRP	None	None	Histidine-Tryptophan
HOMOSERINE	None	None	HOMOSERINE
L-HOMOSERINE	None	None	HOMOSERINE
HOMOSERINE_LACTONE	None	None	HOMOSERINE LACTONE
HYDROLYSATE	None	None	HYDROLYSATE
HYDROXYLAMINE	None	None	HYDROXYLAMINE
HYDROXYUREA	None	None	HYDROXYUREA
HYGROMYCIN B	None	None	HYGROMYCIN B
HYPOOSMOTIC	None	None	HYPOOSMOTIC
IMIPENEM	None	None	IMIPENEM
INDOLE	none	none	INDOLE
INDOLEACETIC ACID	none	none	INDOLEACETIC ACID
IODOACETATE	None	None	IODOACETATE
IODONITROTETRAZOLIUM VIOLET	None	None	IODONITROTETRAZOLIUM VIOLET
IONIZING RADIATION	None	None	IONIZING RADIATION
Iron	None	None	Iron
I-BUTANOL	None	None	ISOBUTANOL
ISOBUTANOL	None	None	ISOBUTANOL
ILE-TYR	None	None	Isoleucine-Tyrosine
ISONIAZID	None	None	ISONIAZID
ISOOCTANE	None	None	ISOOCTANE
ISOPENTENOL	None	None	ISOPENTENOL
Itaconic acid	None	None	Itaconate
KANAMYCIN	None	None	KANAMYCIN
KASUGAMYCIN	None	None	KASUGAMYCIN
KASUGAMYCINE	None	None	KASUGAMYCIN
KETOPROFEN	None	None	KETOPROFEN
LACTATE	none	none	LACTATE
L-LACTATE	none	none	LACTATE
LACTATE CONSUMPTION	None	None	LACTATE CONSUMPTION
L-ALPHA-AMINO-N-BUTYRIC ACID	None	None	L-ALPHA-AMINO-N-BUTYRIC ACID
L-ARGININC	None	None	L-arginine
L-ASPARAGINE	None	None	ASPARAGINE UTILIZATION
L-ASPARTATE	None	none	L-ASPARTATE Utilization
L-Aspartic-B-hydroxamate	None	None	L-Aspartic-B-hydroxamate
L-CYSTEATE	None	None	L-CYSTEATE
L-CYSTEINE	None	None	L-CYSTEINE
LEUCINE CONTAINING PEPTIDES	None	None	LEUCINE CONTAINING PEPTIDES
LEU-ALA	None	None	Leucine-Alanine
LEU-GLU	None	None	Leucine-Glutamate
LEU-GLY	None	None	Leucine-Glycine
LEU-TRP	None	None	Leucine-Tryptophan
LEVOFLOXACIN	None	None	LEVOFLOXACIN
Levulinic acid	None	None	Levulinic acid
LIDOCANE	None	None	LIDOCANE
DEATH	None	None	Lifespan extension
LIMONENE	None	None	LIMONENE
LINCOMYCIN	None	None	LINCOMYCIN
 LITHIUM CHLORIDE	None	None	LITHIUM CHLORIDE
L-LYSINE	None	None	L-LYSINE UTILIZATION
LOMEFLOXACIN	None	None	LOMEFLOXACIN
L-ORNITHINE	None	None	L-ORNITHINE
 LOW SHEAR MODELED MICROGRAVITY	None	None	LOW SHEAR MODELED MICROGRAVITY
L-PROLINE	None	None	L-PROLINE
L-THREO-3-HYDROXYASPARTIC ACID	None	None	L-THREO-3-HYDROXYASPARTIC ACID
L-THREONINE	None	None	L-THREONINE
THREONINE	none	none	L-THREONINE
LB	None	None	Luria-Bertani Broth
LB GROWTH	None	None	Luria-Bertani Broth
VALINE	None	None	L-valine
LYS-ARG	None	None	Lysine-Arginine
LYS-SER	None	None	Lysine-serine
MACROLIDE	None	None	MACROLIDE
 MAGNESIUM SULFATE	None	None	MAGNESIUM SULFATE
 MAGNESIUM SULFATE LIMITATION	None	None	MAGNESIUM SULFATE LIMITATION
D-MALATE	None	None	MALATE
DL-MALATE	None	None	MALATE
L-MALATE	None	None	MALATE
MALATE	None	None	MALATE
MALIC ACID	None	None	MALATE
MALTOSE 	None	None	MALTOSE 
 MANGANESE CHLORIDE	None	None	MANGANESE CHLORIDE
MECILLINAM	None	None	MECILLINAM
MEDIUM CHAIN FATTY ACIDS	None	None	MEDIUM CHAIN FATTY ACIDS
 MELIBIONIC ACID	None	None	MELIBIONIC ACID
 MEMBRANE ANTAGONISTS	None	None	MEMBRANE ANTAGONISTS
MERCURIC CHLORIDE	None	None	Mercury
MERCURY	None	None	MERCURY
METAL IONS	None	None	METAL IONS
Methacrylate	None	None	METHACRYLATE
SODIUM-METHACRYLATE	None	None	METHACRYLATE
 MET-ARG	None	None	Methionine-Arginine
 MET-TRP	None	None	Methionine-Tryptophan
METH	None	None	methotrexate
METHOTREXATE	None	None	methotrexate
 METHANE SULFONATE	None	None	METHYL METHANESULFONATE
METHYL METHANESULFONATE	None	None	METHYL METHANESULFONATE
MMS	None	None	METHYL METHANESULFONATE
METHYL VIOLOGEN	None	None	METHYL VIOLOGEN
 METHYLENE DIPHOSPHONATE	None	None	METHYLENE DIPHOSPHONATE
METHYLGLYOXAL	None	None	METHYLGLYOXAL
MG	None	None	METHYLGLYOXAL
 METHYLTRIOCTYLAMMONIUM CHLORIDE	None	None	METHYLTRIOCTYLAMMONIUM CHLORIDE
METHYLVIOLOGEN	None	None	METHYLVIOLOGEN
METRONIDAZOLE	None	None	METRONIDAZOLE
MICROCIN J25	None	None	MICROCIN J25
MINOCYCLINE	None	None	MINOCYCLINE
MITOMYCIN C	None	None	MITOMYCIN C
MITOMYCINC	None	None	MITOMYCIN C
MONOCHLORAMINE	none	none	MONOCHLORAMINE
MOPS	None	None	MOPS
Moxalactam	None	None	Moxalactam
DNA DAMAGING AGENTS	None	None	Mutagens
 MYRICETIN	None	None	MYRICETIN
 N-ACETYL-D-GLUCOSAMINE	None	None	N-ACETYL-D-GLUCOSAMINE
N-ACETYLGLUCOSAMINE 	None	None	N-ACETYLGLUCOSAMINE 
Nafcillin	None	None	Nafcillin
NAL	None	None	NALIDIXIC ACID
NALIDIXIC ACID	None	None	NALIDIXIC ACID
NALIDIXICACID	None	None	NALIDIXIC ACID
BUTANOL	None	None	n-BUTANOL
N-BUTANOL	None	None	n-BUTANOL
Neomycin	None	None	Neomycin
N-HEXANE	None	None	N-HEXANE
NIAPROOF	None	None	NIAPROOF
NICKEL	None	None	NICKEL
NICKLE CHLORIDE	None	None	NICKEL
NIGERICIN	None	None	NIGERICIN
NITRIC OXIDE	None	None	NITRIC OXIDE
NITRITE	None	None	NITRITE
NITROFURANTOIN	None	None	NITROFURANTOIN
 NITROFURAZONE	None	None	NITROFURAZONE
NOREPINEPHRINE	None	None	NOREPINEPHRINE
NORFLAXIN	None	None	NORFLOXACIN
NORFLOXACIN	None	None	NORFLOXACIN
NORVALINE	None	None	NORVALINE
NOV	None	None	NOVOBIOCIN
NOVOBIOCIN	None	None	NOVOBIOCIN
OCTANE	None	None	OCTANE
OFLOXACIN	None	None	OFLOXACIN
OLEANDOMYCIN	None	None	OLEANDOMYCIN
phenylmercuric acetate	None	None	Organic Mercury
Ornidazole	None	None	Ornidazole
Orphenadrine	None	None	Orphenadrine
Orphenadrine	None	None	Orphenadrine
 OSMOLYTIC AGENTS	None	None	OSMOLYTIC AGENTS
OSMOTIC	None	None	Osmotic stress
OSMOTIC STRESS	None	None	Osmotic stress
OXACILLIN	None	None	OXACILLIN
OXIDATIVE	None	None	OXIDATIVE STRESS
OXIDATIVE STRESS	None	None	OXIDATIVE STRESS
OXYCARBOXIN	None	None	OXYCARBOXIN
OXYTETRACYCLINE	None	None	OXYTETRACYCLINE
Oxytetracycline	None	None	Oxytetracycline
P2 PEPTIDE	None	None	P2 peptide
PARAQUAT	None	None	PARAQUAT
PAROMOMYCIN	None	None	PAROMOMYCIN
Patulin	None	None	Patulin
PENICILLIN G	None	None	PENICILLIN G
Penimepicycline	None	None	Penimepicycline
PEROXIDE	None	None	PEROXIDE
 PH SPECTRUM	None	None	PH SPECTRUM
PHENAZINE METHOSULFATE	None	None	PHENAZINE METHOSULFATE
Phenethicillin	None	None	Phenethicillin
PHE-TRP	None	None	Phenylalanine-Tryptophan
PHLEOMYCIN	None	None	PHLEOMYCIN
LIMITED PHOSPHORUS	None	None	PHOSPHORUS LIMITATION
PHOSPHORUS UTILIZATION	None	None	PHOSPHORUS LIMITATION
P-HYDROXYBENZOIC ACID	None	None	P-HYDROXYBENZOIC ACID
PIPERACILLIN	None	None	PIPERACILLIN
PLUMBAGIN	None	None	PLUMBAGIN
PMS	None	None	PMS
 POLY-L-LYSINE	None	None	POLY-L-LYSINE
POLYMIXIN B	None	None	POLYMIXIN B
POLYMYXIN B	none	none	POLYMIXIN B
POLYMYXINB	None	None	POLYMIXIN B
Potassium chromate	None	None	Potassium chromate
KCL	None	None	POTASSIUM ION
POTASSIUM CHLORIDE	None	None	POTASSIUM ION
POTASSIUM ION	None	None	POTASSIUM ION
POTASSIUM TELLURITE	None	None	POTASSIUM TELLURITE
Pridinol	None	None	Pridinol
PROCAINE	None	None	PROCAINE
PROFLAVINE	None	None	PROFLAVINE
PRO-LEU	None	None	Proline-Leucine
PROPIDIUMIODIDE	None	None	PROPIDIUM IODIDE
PROPIONATE	None	None	PROPIONATE
PUR	None	None	PUROMYCIN
PUROMYCIN	None	None	PUROMYCIN
PUTRESCINE	None	None	PUTRESCINE
PYOCYANIN	None	None	PYOCYANIN
PYRAZINAMIDE	None	None	PYRAZINAMIDE
RADICICOL	None	None	RADICICOL
RADISH SPROUTS	none	none	RADISH SPROUTS
RESPIRATION ATAGONISTS	None	None	RESPIRATION AnTAGONISTS
RHODAMINE 6G	None	None	RHODAMINE 6G
RICH MEDIUM	None	None	RICH MEDIUM
RIFAMPICIN	None	None	RIFAMPICIN
Rifamycin	None	None	Rifamycin
Rolitetracycline	None	None	Rolitetracycline
ROMAINE_LETTUCE	None	None	ROMAINE_LETTUCE
ROMAINE_LETTUCE_LYSATE	None	None	ROMAINE_LETTUCE
RUTHENIUM RED	None	None	RUTHENIUM RED
Sanguinarine	None	None	Sanguinarine
SDS	None	None	SDS
SELENOLIPOIC ACID	None	None	SELENOLIPOIC ACID
SERINE	None	None	SERINE
SER-LEU	None	None	Serine-Leucine
SILVER	None	None	SILVER
SISOMICIN	None	None	SISOMICIN
S-NITROSOGLUTATHIONE	None	None	S-NITROSOGLUTATHIONE
SODIUM M-ARSENITE	None	None	SODIUM ARSENITE
SODIUM AZIDE	None	None	SODIUM AZIDE
NA2CO3	None	None	SODIUM BICARBONATE
Na2CO3	None	None	SODIUM BICARBONATE
SODIUM BROMATE	None	None	SODIUM BROMATE
NACL	None	None	SODIUM chloride
SODIUM CHLORIDE	None	None	SODIUM CHLORIDE
Sodium dichromate	None	None	Sodium dichromate
SODIUM	None	None	SODIUM IONS
Sodium nitrite	none	none	Sodium nitrite
SODIUM SALICYLATE	none	none	SODIUM SALICYLATE
SODIUM SELENITE	None	None	Sodium Selenite
SODIUM TUNGSTATE	none	none	SODIUM TUNGSTATE
SPECTINOMYCIN	None	None	SPECTINOMYCIN
SPINACH	none	none	SPINACH
SPIRAMYCIN	None	None	SPIRAMYCIN
Dihydrostreptomycin	None	None	Streptomycin
STREPTOMYCIN	None	None	STREPTOMYCIN
STREPTONIGRIN	None	None	STREPTONIGRIN
SUCCINATE	None	None	SUCCINATE
Succinic acid	None	None	SUCCINATE
SULFA DRUG	None	None	SULFA DRUG
Sulfachloropyridazine	None	None	Sulfachloropyridazine
SULFADIAZINE	None	None	SULFADIAZINE
Sulfamethazine	None	None	Sulfamethazine
SULFAMETHAXOZOLE	None	None	SULFAMETHOXAZOLE
SULFAMETHIZOLE	None	None	SULFAMETHOXAZOLE
SULFAMETHOXAZOL	None	None	SULFAMETHOXAZOLE
SULFAMETHOXAZOLE	None	None	SULFAMETHOXAZOLE
SULFAMONOMETHOXINE	None	None	SULFAMONOMETHOXINE
SULFANILAMIDE	None	None	SULFANILAMIDE
SULFATHIAZOLE	None	None	SULFATHIAZOLE
Sulfisoxazole	None	None	Sulfisoxazole
SUPEROXIDE	None	None	SUPEROXIDE
 M-TARTARATE	None	None	TARTRATE
TARTARATE	None	None	TARTRATE
TAUROCHOLATE	None	None	TAUROCHOLATE
T-BUTYL HYDROPEROXIDE	None	None	T-BUTYL HYDROPEROXIDE
TELLURITE	None	None	TELLURITE
TETRACYCLINE	None	None	TETRACYCLINE
TETRAPHENYLPHOSPHONIUM BROMIDE	None	None	TETRAPHENYLPHOSPHONIUM BROMIDE
TETRAPHENYLPHOSPHONIUM ION	None	none	TETRAPHENYLPHOSPHONIUM ION
THEOPHYLLINE	None	None	THEOPHYLLINE
THERMAL	None	None	THERMAL
THIOLACTOMYCIN	None	None	THIOLACTOMYCIN
Thioridazine	None	None	Thioridazine
THYMOL	None	None	THYMOL
TIAMULIN	None	None	TIAMULIN
TINIDAZOLE	None	None	TINIDAZOLE
TOBRAMYCIN	None	None	TOBRAMYCIN
TOLUENE	None	None	TOLUENE
TOXIC IONS	None	None	TOXIC IONS
TRICLOSAN	None	None	TRICLOSAN
Trifluoperazine	None	None	Trifluoperazine
TRIMETHOPRIM	None	None	TRIMETHOPRIM
TRIMETHOPRIM	None	None	TRIMETHOPRIM
TRITONX	None	None	TRITON X
TROLEANDOMYCIN	None	None	TROLEANDOMYCIN
TRP-LEU	None	None	Tryptophan-Leucine
TRP-PHE	None	none	Tryptophan-Phenylalanine
TRP-TRP	None	None	Tryptophan-Tryptophan
TRP-TYR	None	None	Tryptophan-Tyrosine
TUNICAMYCIN	None	None	TUNICAMYCIN
L-TYROSINE	None	None	Tyrosine Utilization
TYR-PHE	None	None	TYROSINE-Phenylalanine
TYR-TYR	None	None	Tyrosine-Tyrosine
URINARY_TRACT_ENVIRONMENT	None	None	URINARY_TRACT_INFECTION
URINARY_TRACT_INFECTION	None	None	URINARY_TRACT_INFECTION
UV	None	None	UV Radiation
UV RADIATION	None	None	UV Radiation
VANCOMYCIN	None	None	VANCOMYCIN
VERAPAMIL	None	None	VERAPAMIL
VIOMYCIN	None	None	VIOMYCIN
XYLENE	none	none	XYLENE
ZINC	None	None	ZINC
PROPRIONIC ACID	None	None	PROPRIONATE
GEPOTIDACIN	None	None	GEPOTIDACIN
SABINENE	None	None	SABINENE
VANILLIN	None	None	VANILLIN
ISOPROPANOL	None	None	ISOPROPANOL
ACETONE	None	None	ACETONE
GYRASE INHIBITOR	None	None	GYRASE INHIBITOR
DELAFLOXACIN	None	None	DELAFLOXACIN
HUMAN BETA-DEFENSIN-3	None	None	HUMAN BETA-DEFENSIN-3 ANTIMICROBIAL PEPTIDE
PGLA ANTIMICROBIAL PEPTIDE	None	None	PGLA ANTIMICROBIAL PEPTIDE
TPII ANTIMICROBIAL PEPTIDE	None	None	TPII ANTIMICROBIAL PEPTIDE
PR39 ANTIMICROBIAL PEPTIDE	None	None	PR39 ANTIMICROBIAL PEPTIDE
CAP18	None	None	CAP18 ANTIMICROBIAL PEPTIDE
CECROPIN P1	None	None	CECROPIN P1 ANTIMICROBIAL PEPTIDE
PEX ANTIMICROBIAL PEPTIDE	None	None	PEX ANTIMICROBIAL PEPTIDE
LL-37 ANTIMICROBIAL PEPTIDE	None	None	LL-37 ANTIMICROBIAL PEPTIDE
PLEURICIDIN	None	None	PLEURICIDIN ANTIMICROBIAL PEPTIDE
R8	None	None	R8 ANTIMICROBIAL PEPTIDE
PROA ANTIMICROBIAL PEPTIDE	None	None	PROA ANTIMICROBIAL PEPTIDE
BACTENECIN 5	None	None	BACTENECIN 5 ANTIMICROBIAL PEPTIDE
IND ANTIMICROBIAL PEPTIDE	None	None	IND ANTIMICROBIAL PEPTIDE
NITROXOLINE	None	None	NITROXOLINE
ISOPRENOL	None	None	ISOPRENOL
MELITTIN	None	None	MELITTIN ANTIMICROBIAL PEPTIDE
SUB5	None	None	SUB5 Phage
T4 PHAGE	None	None	T4 PHAGE
T7	None	None	T7 PHAGE
CAP11-1-18M2	None	None	CAP11-1-18M2 ANTIMICROBIAL PEPTIDE
INDOLICIN	None	None	INDOLICIN ANTIMICROBIAL PEPTIDE
T7 PHAGE	None	None	T7 PHAGE
AZLOCILLIN	None	None	AZLOCILLIN
MUPIROCIN	None	None	MUPIROCIN
CINOXACIN	None	None	CINOXACIN
CEFALOTIN	None	None	CEFALOTIN
LOW_PH	None	None	ACID
ZEOCIN	None	None	ZEOCIN
5-AMINOLEVULINIC ACID	None	None	5-AMINOLEVULINIC ACID
P2 PHAGE	None	None	P2 PHAGE
LAMBDA PHAGE	None	None	LAMBDA PHAGE
T6 PHAGE	None	None	T6 PHAGE
186 PHAGE	None	None	186 PHAGE
LZ4 PHAGE	None	None	LZ4 PHAGE
T5 PHAGE	None	None	T5 PHAGE
P1 PHAGE	None	None	P1 PHAGE
CEV2 PHAGE	None	None	CEV2 PHAGE
MEROPENEM	None	None	MEROPENEM
DORIPENEM	None	None	DORIPENEM
GALLIUM	None	None	GALLIUM
OCTANOIC ACID	None	None	OCTANOIC ACID
2_3-BUTANEDIOL	None	None	2_3-BUTANEDIOL
HEXAMETHYLENEDIAMINE	None	None	HEXAMETHYLENEDIAMINE
HEXANOIC ACID	None	None	HEXANOIC ACID
ISOBUTYRIC ACID	None	None	ISOBUTYRIC ACID
COUMARIC ACID	None	None	COUMARIC ACID
GLUTARIC ACID	None	None	GLUTARIC ACID
ADIPIC ACID	None	None	ADIPIC ACID
PROPANEDIOL	None	None	PROPANEDIOL
ACETONITRILE	None	None	ACETONITRILE
N-PROPANOL	None	None	N-PROPANOL
DL-SERINE HYDROXAMATE	None	None	DL-SERINE HYDROXAMATE
N-METHYL-N-OCTYLAMINE	None	None	N-METHYL-N-OCTYLAMINE
DL-2-AMINOBUTYRIC ACID	None	None	DL-2-AMINOBUTYRIC ACID
5-FLUOROURACIL	None	None	5-FLUOROURACIL
DL-3-HYDROXYNORVALINE	None	None	DL-3-HYDROXYNORVALINE
PROMETHAZINE	None	None	PROMETHAZINE
4-NITROQUINOLINE-1-OXIDE	None	None	4-NITROQUINOLINE-1-OXIDE
L-GLUTAMIC ACID-GAMMA-HYDRAZIDE	None	None	L-GLUTAMIC ACID-GAMMA-HYDRAZIDE
BLASTICIDINE S	None	None	BLASTICIDINE S
5-FLUOROOROTIC ACID	None	None	5-FLUOROOROTIC ACID
PROTAMINE SULFATE	None	None	PROTAMINE SULFATE
3-AMINO-1_2_4-TRIAZOLE	None	None	3-AMINO-1_2_4-TRIAZOLE
BACTENECIN 5	None	None	BACTENECIN 5 ANTIMICROBIAL PEPTIDE
BACTENECTIN 7	None	None	BACTENECTIN 7 ANTIMICROBIAL PEPTIDE
INDOLICIDIN	None	None	INDOLICIDIN ANTIMICROBIAL PEPTIDE
PYRRHOCORICIN	None	None	PYRRHOCORICIN ANTIMICROBIAL PEPTIDE
PR-39	None	None	PR-39 ANTIMICROBIAL PEPTIDE
APIDAECIN IB	None	None	APIDAECIN IB ANTIMICROBIAL PEPTIDE
PROTAMINE	None	None	PROTAMINE ANTIMICROBIAL PEPTIDE
CECROPIN P1	None	None	CECROPIN P1 ANTIMICROBIAL PEPTIDE
SYNTHETIC CECROPIN-MELITTIN HYBRID	None	None	SYNTHETIC CECROPIN-MELITTIN HYBRID ANTIMICROBIAL PEPTIDE
PROTEGRIN-1	None	None	PROTEGRIN-1 ANTIMICROBIAL PEPTIDE
LL-37	None	None	LL-37 ANTIMICROBIAL PEPTIDE
MAGAININ 2	None	None	MAGAININ 2 ANTIMICROBIAL PEPTIDE
PEXIGANAN	None	None	PEXIGANAN ANTIMICROBIAL PEPTIDE
D28	None	None	D28 ANTIMICROBIAL PEPTIDE
R8	None	None	R8 ANTIMICROBIAL PEPTIDE
PLEUROCIDIN	None	None	PLEUROCIDIN ANTIMICROBIAL PEPTIDE
TACHYPLESIN II	None	None	TACHYPLESIN II ANTIMICROBIAL PEPTIDE
SB006 (M6)	None	None	SB006 (M6) ANTIMICROBIAL PEPTIDE
PEPTIDE GLYCINE-LEUCINE AMIDE	None	None	PEPTIDE GLYCINE-LEUCINE AMIDE ANTIMICROBIAL PEPTIDE
CAP18	None	None	CAP18 ANTIMICROBIAL PEPTIDE
HUMAN BETA-DEFENSIN-3	None	None	HUMAN BETA-DEFENSIN-3 ANTIMICROBIAL PEPTIDE
NCR335	None	None	NCR335 ANTIMICROBIAL PEPTIDE
ANGINEX	None	None	ANGINEX ANTIMICROBIAL PEPTIDE
OCTANOATE	None	None	OCTANOIC ACID
LOW PH	None	None	ACID
1-PENTANOL	None	None	1-PENTANOL
CEPHALEXIN	None	None	CEPHALEXIN
CITRAL	None	None	CITRAL
CARVACROL	None	None	CARVACROL
1_10-Phenanthroline	None	None	1_10-Phenanthroline
BENSERAZIDE	None	None	BENSERAZIDE
HIGH PH	None	None	Alkaline
ISOPENTANOL	None	None	ISOPENTANOL
PINENE	None	None	PINENE
T3 PHAGE	None	None	T3 PHAGE
T4_PHAGE	None	None	T4 PHAGE
CEV1_PHAGE	None	None	CEV1 PHAGE
N4_PHAGE	None	None	N4 PHAGE
T2 PHAGE	None	None	T2 PHAGE
T3_PHAGE	None	None	T3 PHAGE
T5_PHAGE	None	None	T5 PHAGE
P1_PHAGE	None	None	P1 PHAGE
T6_PHAGE	None	None	T6 PHAGE
LZ4_PHAGE	None	None	LZ4 PHAGE
T2_PHAGE	None	None	T2 PHAGE
LAMBDA_PHAGE	None	None	LAMBDA PHAGE
186_PHAGE	None	None	186 PHAGE
T7_PHAGE	None	None	T7 PHAGE
CEV1 PHAGE	None	None	CEV1 PHAGE
N4 PHAGE	None	None	N4 PHAGE
CEV2_PHAGE	None	None	CEV2 PHAGE
IONIC LIQUIDS	None	None	IONIC LIQUIDS
nickel chloride	NONE	NONE	nickel
d-serine	NONE	NONE	d-serine
L-serine	None	None	L-serine
Thallium(I) acetate	None	none	Thallium
Cholin acetate	None	none	Cholin acetate
1-ethyl-3-methylimidazolium chloride	None	none	[EMIM]Cl
Chlorite	None	none	BLEACH
1-ethyl-3-methylimidazolium acetate	None	none	[EMIM]Ac
Dimethyl Sulfoxide	None	none	DMSO
syringaldehyde	None	none	syringaldehyde
Nalidixic	None	none	Nalidixic Acid
5-Hydroxymethylfurfural	None	none	HMF
sodium fluoride	None	none	Sodium Fluoride
copper chloride	None	none	Copper
Aluminum chloride	None	none	Aluminum chloride
Doxycycline hyclate	None	none	DOxycycline
2-Furfuraldehyde	None	none	Furfural
Fusidic	None	none	Fusidic Acid
Chloride	None	none	Chloride
benzoic	None	none	Benzoic Acid
Phosphomycin	None	none	FOSFOMYCIN
Benzethonium	None	none	BENZETHONIUM CHLORIDE
Benzalkonium	None	none	BENZALKONIUM CHLORIDE
